. . 1 1 1 1 1 1 1 1 1 1 1 1 1 1 1 1 1 1 1 1 1 1 1 1 1 1 1 1 1 1
. . 1 . d . . . . . . . . . 1 . . . L 1 . . . . . . . . . . . 1
. . 1 . 1 . 1 1 1 1 1 1 1 . 1 . 1 . 1 1 . 1 1 1 1 1 1 1 1 1 . 1
. . 1 . 1 . . . . . . . 1 . . . 1 . 1 . . 1 . . . . . 1 . . . 1
. . 1 . 1 1 1 1 1 1 1 . 1 1 1 1 1 . 1 . 1 1 . 1 1 1 . 1 . 1 1 1
. . 1 I 1 . . . . . 1 . . . . 1 . . 1 . . 1 . 1 I 1 . 1 . . . 1
. . 1 1 1 . 1 1 1 . 1 1 1 1 . 1 . 1 1 1 . 1 . d . 1 . 1 1 1 . 1
. . 1 . . . . . 1 . . . . 1 . 1 . 1 . . . 1 1 1 1 1 . 1 . . . 1
. . 1 . 1 1 1 . 1 . 1 1 . 1 . 1 . 1 . 1 1 1 . . . . . 1 . 1 L 1
. . 1 . 1 L . . . . 1 L . . . 1 . 1 . . . . . 1 1 1 1 1 . 1 1 1
. . 1 . 1 1 1 1 1 1 1 1 1 1 1 1 . 1 . 1 L 1 1 1 . . . 1 . . L 1
. . 1 . . . 1 L . . 1 L . . . . . . . 1 1 1 . . . 1 . 1 . 1 1 1
1 1 1 1 1 . 1 . 1 . 1 1 1 1 1 . 1 1 1 1 . . . 1 1 1 . . . 1 L 1
1 . . . 1 . 1 . 1 . . . 1 . . . L 1 . 1 . 1 1 1 L 1 1 1 1 1 . 1
T . L . . . 1 . 1 . 1 . . . 1 1 1 1 . . . . . . . 1 L 1 . . . 1
1 . . . 1 1 1 . . . 1 1 1 1 1 . . . . 1 1 1 1 1 1 1 . . . 1 . 1
1 1 1 1 1 . . . 1 1 1 . d I 1 . 1 1 . . . . . 1 . . . 1 L 1 . 1
. . 1 . . . 1 1 1 L 1 . 1 1 1 . . . . 1 1 1 . 1 . 1 1 1 1 1 . 1
. . 1 . 1 . 1 . . . 1 . 1 . . . 1 1 1 1 . . . . . 1 L . . . . 1
. . 1 . 1 . . . 1 . 1 . . . 1 1 1 . . . . 1 1 1 1 1 1 . 1 1 1 1
. . 1 . 1 1 1 1 1 . 1 . 1 1 1 L 1 . 1 1 1 1 I 1 . . . . . . L 1
. . 1 . 1 . . . . . 1 . . L 1 . . . 1 . . d . 1 . 1 1 1 1 1 1 1
. . 1 . . . 1 1 1 1 1 1 . 1 1 . 1 1 1 . 1 1 1 1 . . . . . 1 L 1
. . 1 1 1 . 1 . L 1 . . . 1 . . . . . . 1 L . . . 1 . 1 . 1 . 1
. . 1 L 1 . 1 . 1 1 . 1 1 1 . 1 1 1 . 1 1 1 1 . 1 1 . 1 . . . 1
. . 1 . 1 . . . 1 . . 1 L 1 . 1 L . . 1 . L 1 . . 1 . 1 1 . . 1
. . 1 . . . 1 1 1 . 1 1 . 1 . 1 1 1 . 1 . 1 1 1 . . . L 1 D 1 1
. . 1 . 1 . . . . . 1 . . . . . . 1 L 1 . . . . . 1 1 1 1 . . 1
. . 1 . 1 1 1 1 1 1 1 . 1 1 . 1 . 1 1 1 . 1 . 1 1 1 . D . . 1 1
. . 1 . . . . . . . . . 1 L . 1 L 1 I d . 1 . . . . . 1 . . F *
. . 1 1 1 1 1 1 1 1 1 1 1 1 1 1 1 1 1 1 1 1 1 1 1 1 1 1 1 1 1 1
