. 1 1 1 1 1 1 1 1 1 1 1 1 1 4 5 1 1 1 1 1 1 1 1 1 1 1 1 1 .
. 1 + + + + + + + + + + + + 3 3 + + + + + + + + + + + + 1 .
. 1 + 1 2 2 1 + 1 2 2 2 1 + 3 3 + 1 2 2 2 1 + 1 2 2 1 + 1 .
. 1 O 3 . . 3 + 3 . . . 3 + 3 3 + 3 . . . 3 + 3 . . 3 O 1 .
. 1 + 1 2 2 1 + 1 2 2 2 1 + 1 1 + 1 2 2 2 1 + 1 2 2 1 + 1 .
. 1 + + + + + + + + + + + + + + + + + + + + + + + + + + 1 .
. 1 + 1 2 2 1 + 1 1 + 1 2 2 2 2 2 2 1 + 1 1 + 1 2 2 1 + 1 .
. 1 + 1 2 2 1 + 3 3 + 1 2 2 4 5 2 2 1 + 3 3 + 1 2 2 1 + 1 .
. 1 + + + + + + 3 3 + + + + 3 3 + + + + 3 3 + + + + + + 1 .
. 1 1 1 1 1 1 + 3 6 2 2 1 . 3 3 . 1 2 2 7 3 + 1 1 1 1 1 1 .
. . . . . . 1 + 3 5 2 2 1 . 1 1 . 1 2 2 4 3 + 1 . . . . . .
. . . . . . 1 + 3 3 . . . . . . . . . . 3 3 + 1 . . . . . .
. . . . . . 1 + 3 3 . 1 1 1 . . 1 1 1 . 3 3 + 1 . . . . . .
. 1 1 1 1 1 1 + 1 1 . 1 . . . . . . 1 . 1 1 + 1 1 1 1 1 1 .
. . . . . . . + . . . 1 . . . . . . 1 . . . + . . . . . . .
. 1 1 1 1 1 1 + 1 1 . 1 . . . . . . 1 . 1 1 + 1 1 1 1 1 1 .
. . . . . . 1 + 3 3 . 1 1 1 1 1 1 1 1 . 3 3 + 1 . . . . . .
. . . . . . 1 + 3 3 . . . . . . . . . . 3 3 + 1 . . . . . .
. . . . . . 1 + 3 3 . 1 2 2 2 2 2 2 1 . 3 3 + 1 . . . . . .
. 1 1 1 1 1 1 + 1 1 . 1 2 2 4 5 2 2 1 . 1 1 + 1 1 1 1 1 1 .
. 1 + + + + + + + + + + + + 3 3 + + + + + + + + + + + + 1 .
. 1 + 1 2 2 1 + 1 2 2 2 1 + 3 3 + 1 2 2 2 1 + 1 2 2 1 + 1 .
. 1 + 1 2 4 3 + 1 2 2 2 1 + 1 1 + 1 2 2 2 1 + 3 5 2 1 + 1 .
. 1 O + + 3 3 + + + + + + + + + + + + + + + + 3 3 + + O 1 .
. 6 2 1 + 3 3 + 1 1 + 1 2 2 2 2 2 2 1 + 1 1 + 3 3 + 1 2 7 .
. 5 2 1 + 1 1 + 3 3 + 1 2 2 4 5 2 2 1 + 3 3 + 1 1 + 1 2 4 .
. 1 + + + + + + 3 3 + + + + 3 3 + + + + 3 3 + + + + + + 1 .
. 1 + 1 2 2 2 2 7 6 2 2 1 + 3 3 + 1 2 2 7 6 2 2 2 2 1 + 1 .
. 1 + 1 2 2 2 2 2 2 2 2 1 + 1 1 + 1 2 2 2 2 2 2 2 2 1 + 1 .
. 1 + + + + + + + + + + + + + + + + + + + + + + + + + + 1 .
. 1 1 1 1 1 1 1 1 1 1 1 1 1 1 1 1 1 1 1 1 1 1 1 1 1 1 1 1 .
Teleport 0 14 left 29 14 right
Turn 63
2 1
7 1
13 1
16 1
22 1
27 1
2 5
10 5
13 5
16 5
19 5
22 5
27 5
2 8
7 8
10 8
13 8
16 8
19 8
22 8
27 8
10 11
13 11
16 11
19 11
7 14
10 14
19 14
22 14
10 17
19 17
2 20
7 20
10 20
13 20
16 20
19 20
22 20
27 20
2 23
4 23
7 23
10 23
13 23
16 23
19 23
22 23
25 23
27 23
2 26
4 26
7 26
10 26
13 26
16 26
19 26
22 26
25 26
27 26
2 29
13 29
16 29
27 29
